                                                |2.4 |2.3 |2.2|D|
Audio encryption                                |AENC|AENC|CRA|X|
Attached picture                                |APIC|APIC|PIC|X|
seek point index                                |ASPI|    |   | 
Comments                                        |COMM|COMM|COM|X|
Commercial frame                                |COMR|COMR|   |X|
Encryption method registration                  |ENCR|ENCR|   |X|
Equalization                                    |EQU2|EQUA|EQU|X|
Event timing codes                              |ETCO|ETCO|ETC|X|
General encapsulated object                     |GEOB|GEOB|GEO|X|
Group identification registration               |GRID|GRID|   |X|
Linked information                              |LINK|LINK|LNK|
Music CD identifier                             |MCDI|MCDI|MCI|
MPEG location lookup table                      |MLLT|MLLT|MLL|
Ownership frame                                 |OWNE|OWNE|   |
Private frame                                   |PRIV|PRIV|   |
Play counter                                    |PCNT|PCNT|CNT|
Popularimeter                                   |POPM|POPM|POP|
Position synchronisation frame                  |POSS|POSS|   |
Recommended buffer size                         |RBUF|RBUF|BUF|
Relative volume adjustment                      |RVA2|RVAD|RVA|
Reverb                                          |RVRB|RVRB|REV|
Seek frame                                      |SEEK|    |   |
Signature frame                                 |SIGN|    |   |
Synchronised lyric/text                         |SYLT|SYLT|SLT|
Synchronised tempo codes                        |SYTC|SYTC|STC|
Album/Movie/Show title                          |TALB|TALB|TAL|X|
BPM (beats per minute)                          |TBPM|TBPM|TBP|X|
Composer                                        |TCOM|TCOM|TCM|X|
Content type                                    |TCON|TCON|TCO|X|
Copyright message                               |TCOP|TCOP|TCR|X|
Encoding time                                   |TDEN|    |   |X|
Playlist delay                                  |TDLY|TDLY|TDY|
Original release time                           |TDOR|    |   |
Recording time                                  |TDRC|    |   |
Release time                                    |TDRL|    |
Tagging time                                    |TDTG|    |
Encoded by                                      |TENC|TENC|TEN|X|
Lyricist/Text writer                            |TEXT|TEXT|TXT|
FIle type                                       |TFLT|TFLT|TFT|X|
Involved people list                            |TIPL|IPLS|IPL|X|
Content group description                       |TIT1|TIT1|TT1|X|
Title/songname/content description              |TIT2|TIT2|TT2|
Subtitle/Description refinement                 |TIT3|TIT3|TT3|
Initial key                                     |TKEY|TKEY|TKE|X|
Language(s)                                     |TLAN|TLAN|TLA|
Length                                          |TLEN|TLEN|TLE|
Musician credits list                           |TMCL|    |
Media type                                      |TMED|TMED|TMT|
Mood                                            |TMOO|    |
Original album/movie/show title                 |TOAL|TOAL|TOT|
Original filename                               |TOFN|TOFN|TOF|
Original lyricist(s)/text writer(s)             |TOLY|TOLY|TOL|
Original artist(s)/performer(s)                 |TOPE|TOPE|TOA|
File owner/licensee                             |TOWN|TOWN|   |X|
Lead performer(s)/Soloist(s)                    |TPE1|TPE1|TP1|
Band/orchestra/accompaniment                    |TPE2|TPE2|TP2|X|
Conductor/performer refinement                  |TPE3|TPE3|TP3|X|
Interpreted, remixed, or otherwise modified by  |TPE4|TPE4|TP4|X|
Part of a set                                   |TPOS|TPOS|TPA|
Produced notice                                 |TPRO|    |
Publisher                                       |TPUB|TPUB|TPB|
Track number/Position in set                    |TRCK|TRCK|TRK|
Internet radio station name                     |TRSN|TRSN|   |X|
Internet radio station owner                    |TRSO|TRSO|   |X|
Album sort order                                |TSOA|    |   |X|
Performer sort order                            |TSOP|    |
Title sort order                                |TSOT|    |
ISRC (international standard recording code)    |TSRC|TSRC|TRC|X|
Software/Hardware and settings used for encoding|TSSE|TSSE|TSS|
Set subtitle                                    |TSST|    |
User defined text information frame             |TXXX|TXXX|TXX|
Unique file identifier                          |UFID|UFID|UFI|
Terms of use                                    |USER|USER|
Unsynchronised lyric/text transcription         |USLT|USLT|ULT|
Commercial information                          |WCOM|WCOM|WCM|X|
Copyright/Legal information                     |WCOP|WCOP|WCP|X|
Official audio file webpage                     |WOAF|WOAF|WAF|
Official artist/performer webpage               |WOAR|WOAR|WAR|
Official audio source webpage                   |WOAS|WOAS|WAS|
Official Internet radio station homepage        |WORS|WORS|
Payment                                         |WPAY|WPAY|
Publishers official webpage                     |WPUB|WPUB|WPB|
User defined URL link frame                     |WXXX|WXXX|WXX|
Date                                            |    |TDAT|TDA|X|
Time                                            |    |TIME|TIM|
Original release year                           |    |TORY|TOR|
Recording dates                                 |    |TRDA|TRD|
Size                                            |    |TSIZ|TSI|
Year                                            |    |TYER|TYE|
Encrypted meta frame                            |    |    |CRM|X|